
NO ./north.xpm
SO ./south.xpm
WE ./west.xpm
EA ./east.xpm

F 153,255,204
C 153,204,255


111111111
100000011
100111001
100000001
1000S0001
100000001
101000101
100000001
111111111