
NO ./north.xpm
SO ./south.xpm
WE ./west.xpm
EA ./east.xpm







F 220,100,0
C 225,30,0


11111111
10000011
10000001
10010011
10010001
10000001
100N0101
11111111
